Gliv                               - GLiv is an OpenGL image viewer
NetworkManager-openconnect         - NetworkManager VPN integration for openconnect
NetworkManager-openvpn             - NetworkManager VPN integration for OpenVPN
NetworkManager-pptp                - NetworkManager VPN integration for PPTP
NetworkManager-vpnc                - NetworkManager VPN integration for vpnc
OpenCPN                            - OpenCPN: A concise ChartPlotter/Navigator.
OpenGTL                            - The Graphics Transformation Languages is a set of library
OpenGTL-devel                      - The Graphics Transformation Languages is a set of library
Ri-li                              - Chu chu chuu
abe                                - Yet another platform game
acct                               - System resource accounting utilities
acpica                             - ACPI debugging tools written by Intel
aeidon                             - Editor for text-based subtitle files
airstrike                          - A 2d dogfight game
alpine                             - Easy to use email client
alsa-lib                           - The Advanced Linux Sound Architecture (ALSA) library
alsa-lib-32bit                     - 32-bit shared libraries for alsa-lib
alsa-lib-devel                     - Development files for alsa-lib
alsa-utils                         - Advanced Linux Sound Architecture (ALSA) utilities
alure                              - Audio Library Utilities REtooled
alure-devel                        - Development files for ALURE
amoebax                            - A cute and addictive action-puzzle game
amsn                               - A free and open source program to connect MSN Messenger networks
amsn-plugins                       - Various aMSN plugins
amsn-skin-dark-matter              - Dark Matter skin for aMSN
amule                              - eMule (ED2K) client and file-sharing application
amule-alc                          - aMule link creator
amule-cas                          - aMule online statistics tool
amulecmd                           - Console-based control tool for aMule daemon
amuleweb                           - aMule web server
apbs                               - Adaptive Poisson Boltzmann Solver
apbs-devel                         - Development files for apbs
aqbanking                          - A library for online banking functions and financial data import/export
aqbanking-devel                    - Development files for aqbanking
aquafont                           - Far East fonts
arkpandora-fonts                   - Arkpandora MS-TTF replacement font pack
armagetronad-moviepack             - Armagetron AD moviepack
armagetronad-moviesounds           - Armagetron AD sound package
artemisia-fonts                    - artemisia fonts
ataturk-font                       - Ataturk's handwriting
atlas                              - Automatically Tuned Linear Algebra Software (BLAS implementation)
atlas-devel                        - Development files for atlas
atmel-firmware                     - Firmware for Atmel at76c50x wireless network chips
atomicparsley                      - MPEG-4 metadata tool
attica                             - Implementation of the Open Collaboration Services API
attica-devel                       - Development files for attica
aubio                              - An audio labelling library
aubio-devel                        - Development files for aubio
audacious                          - an advanced audio player
audacious-devel                    - an advanced audio player
autopano-sift-C                    - Automatic control point generator
axel                               - Console based download accelerator program.
comp-scale                         - Skeleton module for Enlightenment
e-module-alarm                     - Enlightenment Alarm Module
e-module-calendar                  - Calendar module for Enlightenment
e-module-cpu                       - CPU monitor module
e-module-deskshow                  - Show Desktop Module
e-module-diskio                    - I/O Disk monitoring module
e-module-drawer                    - Drawer module for Enlightenment17 desktop shell
e-module-eektool                   - Execute a shell command and display the output
e-module-eenvader-fractal          - EEnvader-fractal is a wallpaper
e-module-elfe                      - A Enlightenment Launcher for embedded devices
e-module-empris                    - A Enlightenment Module for Control music players like Amarok, Audacious, xmms2 (via mpris bridge), vlc and others
e-module-engage                    - A Enlightenment application launcher
e-module-eooorg                    - openoffice preloader module for Enlightenment
e-module-everything-aspell         - A Enlightenment application launcher
e-module-everything-pidgin         - Everything Pidgin module for Enlightenment
e-module-everything-places         - Everything Places module for Enlightenment
e-module-everything-shotgun        - An e17 shotgun plugin for the "everything" module
e-module-everything-skeleton       - A SKEL Plugin for Everything
e-module-everything-tracker        - Tracker search for Everything
e-module-everything-wallpaper      - Wallpaper setting module
e-module-everything-websearch      - Websearch Module for E17
e-module-eweather                  - Eweather is an e17 application that displays the current weather and forecasts for several days.
e-module-exebuf                    - Exebuf Program Launcher
e-module-execwatch                 - Execwatch module for Enlightenment
e-module-flame                     - Flame module for Enlightenment
e-module-forecasts                 - Forecast module for Enlightenment
e-module-iiirk                     - Iiirk module for Enlightenment
e-module-itask                     - Application launcher and taskbar based on the good old engage
e-module-mail                      - Mail module for Enlightenment
e-module-mem                       - Memory monitor module for Enlightenment
e-module-moon                      - Moon Clock module for Enlightenment
e-module-mpdule                    - Music Player Daemon (MPD) module for Enlightenment17 desktop shell
e-module-net                       - Network interface monitor module for Enlightenment
e-module-news                      - News module for Enlightenment
e-module-penguins                  - E17 Module that display penguins
e-module-photo                     - Photo module for Enlightenment17 desktop shell
e-module-places                    - Places module for Enlightenment
e-module-rain                      - Rain module for Enlightenment
e-module-screenshot                - screen capture module for Enlightenment
e-module-skel                      - a module for Enlightenment
e-module-snow                      - Snow module for the Enlightenment
e-module-taskbar                   - Taskbar module for Enlightenment
e-module-tclock                    - Clock module for Enlightenment
e-module-uptime                    - Uptime module for Enlightenment
e-module-weather                   - Weather module for Enlightenment
e-module-winlist-ng                - the Winlist NG module for Enlightenment
e-module-winselector               - Winselector module for Enlightenment
e-module-wlan                      - Wlan module for Enlightenment
e_dbus                             - A D-Bus wrapper for EFL based applications
e_dbus-devel                       - Development files for e_dbus
eboard                             - A GTK+ chess board
eclipse-cdt                        - C/C++ Development Tools (CDT) for Eclipse
eclipse-jdt                        - Java Development Tools for Eclipse
eclipse-pde                        - Plugin Development Tools (PDT) for Eclipse
ecofont                            - Eco friendly and cost reducing printing fonts
econcentration                     - contentration game
econnman                           - EFL user interface for connman
ecore                              - Enlightenment event/X abstraction layer
ecore-devel                        - Development files for ecore
editje                             - Visual editor for edje files
edje                               - Graphical layout and animation library
edje-devel                         - Development files for edje
eet                                - E file chunk reading/writing library
eet-devel                          - Development files for eet
eeze                               - Enlightenment's integration to devices
eeze-devel                         - Development files for eeze
efax-gtk                           - GTK2 frontend for efax
efreet                             - MIME-standards handler for E17 desktop shell
efreet-devel                       - Development files for efreet
eina                               - Multi-platform library provides optimized data types
eina-devel                         - Development files for eina
eio                                - Eio is an asynchronous input output library
eio-devel                          - Development files for eio
elementary                         - Enlightenment's basic widget set
elementary-devel                   - Development files for elementary
emacs-emms                         - The Emacs Multimedia System
emap                               - A map manager for Enlightenment
emap-devel                         - Development files for emap
embryo                             - Enlightenment bytecode virtual machine
embryo-devel                       - Development files for embryo
emotion                            - Enlightenment video and media library
emotion-devel                      - Development files for emotion
emprint                            - Enlightenment screen capture utility
enca                               - Charset analyzer
enca-devel                         - Development files for enca
engine_pkcs11                      - A PKCS#11 engine for use with OpenSSL
enigma                             - Puzzle game similiar to 0xyd
enki                               - A photo and album manager for Enlightenment
epdf                               - Libraries for envision
epdf-devel                         - Development files for epdf
erlang-appmon                      - A utility used to supervise Applications executing on several Erlang nodes
erlang-asn1                        - Provides support for Abstract Syntax Notation One
erlang-base                        - Erlang architecture independent files
erlang-common_test                 - A portable framework for automatic testing
erlang-compiler                    - A byte code compiler for Erlang which produces highly compact code
erlang-cosEvent                    - Orber OMG Event Service
erlang-cosEventDomain              - Orber OMG Event Domain Service
erlang-cosFileTransfer             - Orber OMG File Transfer Service
erlang-cosNotification             - Orber OMG Notification Service
erlang-cosProperty                 - Orber OMG Property Service
erlang-cosTime                     - Orber OMG Timer and TimerEvent Service
erlang-cosTransactions             - Orber OMG Transaction Service
erlang-crypto                      - Cryptographical support
erlang-debugger                    - A debugger for debugging and testing of Erlang programs
erlang-devel                       - Development headers and files for Erlang
erlang-dialyzer                    - A DIscrepany AnaLYZer for ERlang programs
erlang-docbuilder                  - Tool for generating HTML documentation for applications
erlang-docs                        - Erlang documentation
erlang-edoc                        - A utility used to generate documentation out of tags in source files
erlang-emacs                       - Erlang integration for Emacs
erlang-erl_docgen                  - A utility used to generate erlang HTML documentation
erlang-erl_interface               - Low level interface to C
erlang-et                          - An event tracer for Erlang programs
erlang-eunit                       - Support for unit testing
erlang-gs                          - A library for Tcl/Tk support in Erlang
erlang-hipe                        - High Performance Erlang
erlang-ic                          - IDL compiler
erlang-inets                       - A set of services such as a Web server and a ftp client etc
erlang-inviso                      - A trace tool for both development and delivered systems
erlang-jinterface                  - A library for accessing Java from Erlang
erlang-megaco                      - Megaco/H.248 support library
erlang-mnesia                      - A heavy duty real-time distributed database
erlang-observer                    - A set of tools for tracing and investigation of distributed systems
erlang-odbc                        - A library for unixODBC support in Erlang
erlang-orber                       - A CORBA Object Request Broker
erlang-os_mon                      - A monitor which allows inspection of the underlying operating system
erlang-otp_mibs                    - SNMP management information base for Erlang/OTP nodes
erlang-parsetools                  - A set of parsing and lexical analysis tools
erlang-percept                     - A concurrency profiler tool
erlang-pman                        - A graphical process manager used to inspect Erlang processes
erlang-public_key                  - API to public key infrastructure
erlang-reltool                     - A release management tool
erlang-runtime_tools               - A set of tools to include in a production system
erlang-snmp                        - Simple Network Management Protocol (SNMP) support
erlang-ssh                         - Secure Shell application with sftp and ssh support
erlang-ssl                         - Secure Socket Layer support
erlang-suite                       - Package which pulls in complete erlang suite
erlang-syntax_tools                - A set of tools for dealing with erlang sources
erlang-test_server                 - The OTP Test Server
erlang-toolbar                     - A tool bar simplifying access to the Erlang tools
erlang-tools                       - A set of programming tools including a coverage analyzer etc
erlang-tv                          - An ETS and MNESIA graphical table visualizer
erlang-typer                       - TYPe annotator for ERlang programs
erlang-webtool                     - A tool that simplifying the use of web based Erlang tools
erlang-wx                          - A library for wxWidgets support in Erlang
erlang-xmerl                       - Provides support for XML 1.0
esound                             - The Enlightened Sound Daemon
esound-devel                       - Development files for esound
ethumb                             - Thumbnail generation library
ethumb-devel                       - Development files for ethumb
etrophy                            - A Enlightenment library that manages scores, trophies and unlockables
etrophy-devel                      - enlil için geliştirme dosyaları
expect                             - Tool for automating interactive applications
extreme-tuxracer                   - Tux racing game
gnu-gs-fonts-std                   - Ghostscript standard fonts
gnubg                              - GNU BackGammoni
gnuchess-book                      - Opening book for GNU Chess
gnugo                              - A GO game server and player
gnugo-docs                         - gnugo documentation files
gnujump                            - Addictive jump game
goldendict                         - An advanced multiple language translator with built-in encyclopedia and custom-made dictionary support
goonies                            - Remake of the MSX Goonies game
gperftools                         - Google Performance Tools
gperftools-devel                   - Development headers for gperftools
gperftools-docs                    - Documentation files for gperftools
gpsd                               - GPS daemon and library to support serial/USB GPS devices
gpsd-clients                       - Various text based and graphical clients for gpsd
gpsd-devel                         - Development files for gpsd
graphite2                          - SILGraphite: rendering non-roman scripts
graphite2-devel                    - graphite2 için geliştirme dosyaları
gretl                              - A cross-platform software package for econometric analysis
gretl-devel                        - Development files for gretl
gretl-emacs                        - Gretl module for Emacs
gsl                                - GNU scientific library
gsl-devel                          - Development files for gsl
gst-buzztard                       - Buzztard gstreamer extensions
gst-buzztard-doc                   - gst-buzzard için doc dosyaları
gst-plugins-good                   - A set of good-quality plugins for GStreamer
gst-plugins-ugly                   - Other plugins for gstreamer
gst-python                         - GStreamer Python bindings
gst-python-devel                   - Development files for gst-python
gtk-sharp                          - A C# language binding for the GTK+
gtk-sharp-devel                    - Development files for gtk-sharp
gtkglarea                          - GL extensions for gtk+
gtkglarea-devel                    - Development files for gtkglarea
gtkglext                           - OpenGL extension to GTK+
gtkglext-devel                     - Development headers for gtkglext
gtkglextmm                         - C++ bindings for GtkGLExt
gtkglextmm-devel                   - C++ bindings for GtkGLExt
guilt                              - Scripts to manage quilt-like patches on top of git
guitar-tuner                       - GTK ile yazılmış bir gitar akort uygulaması.
gupnp-igd                          - A library to handle UPnP IGD port mapping
gupnp-igd-devel                    - Development files for gupnp-igd
gutenprint                         - High quality printer drivers
gutenprint-devel                   - Development files for gutenprint
gv                                 - Standard ghostscript frontend used by programs like LyX
gweled                             - A puzzle game similar to "Bejeweled" or "Diamond Mine"
gwenhywfar                         - A multi-platform helper library
gwenhywfar-devel                   - Development files for gwenhywfar
gyachi                             - A GTK+ based Yahoo! Chat client
hugs98                             - The Hugs98 Haskell interpreter
kompozer-devel                     - kompozer için geliştirme dosyaları
lablgl                             - Objective Caml interface to OpenGL
lablgtk2                           - LablGTK is is an Objective Caml interface to gtk+
lablgtk2-docs                      - LablGTK is is an Objective Caml interface to gtk+
lash                               - LASH Audio Session Handler
lash-devel                         - Development files for lash
lastfm                             - The Last.fm Player
latex-beamer                       - LaTeX class for creating presentations using a video projector
latex-envlab                       - Latex module to format envelopes
latex-leaflet                      - Create leaflet-type brochures
latex-maltese                      - Facilitate the input of Maltese characters
lbreakout2                         - Bouncing balls puzzle game
lensfun                            - A programming library for rectifying and simulating photographic lens distortions
lensfun-devel                      - Development files for lensfun
libalkimia                         - Library with common classes and functionality used by KDE finance applications
libalkimia-devel                   - Development files for libalkimia
libass                             - Subtitle rendering library
libass-devel                       - Development files for libass
libavc1394                         - library for the 1394 Trade Association AV/C (Audio/Video Control) Digital Interface Command Set
libavc1394-devel                   - Development files for libavc1394
libbml                             - Buzztard shared libraries
libbml-devel                       - Buzztard shared libraries
libcaca                            - A library that creates colored ASCII-art graphics
libcaca-devel                      - Development files for libcaca
libcaptury                         - Multimedia capturing framework
libcaptury-devel                   - Development files for libcaptury
libcdaudio                         - A library for controlling CD-ROM devices
libcdaudio-devel                   - Development files for libcdaudio
libcddb                            - A library for accessing a CDDB server
libcddb-devel                      - Development files for libcddb
libcdio                            - A library to encapsulate CD-ROM reading and control
libcdio-devel                      - Development files for libcdio
libcdio-paranoia                   - CD paranoia libraries from libcdio
libcdio-paranoia-devel             - Development files for libcdio-paranoia
libcgroup                          - Tools and libraries to control and monitor control groups
libcgroup-devel                    - Development files for libcgroup
libdaemon                          - Library for writing UNIX daemons
libdaemon-32bit                    - 32-bit shared libraries for libdaemon
libdaemon-devel                    - Development files for libdaemon
libdvdnav                          - libdvdnav is a library for developers of multimedia applications
libdvdnav-devel                    - Development files for libdvdnav
libechonest                        - C++ wrapper for the Echo Nest API
libechonest-devel                  - Development files for libechonest
libepc                             - Easy Publish and Consume Library
libepc-devel                       - libepc header files
liberation-fonts                   - Font collection similar to ones found in Microsoft Windows
libevent                           - A library to execute a function when a specific event occurs on a file descriptor
libevent-devel                     - Development files for libevent
libeweather                        - Weather library for Enlightenment
libeweather-devel                  - Development files for libeweather
libexttextcat                      - Text categorization library
libexttextcat-devel                - libexttextcat için geliştirme dosyaları
libftdi                            - A library for accessing to FTDI USB chips
libftdi-devel                      - Development files for libftdi
libgadu                            - A Gadu-gadu protocol compatible communications library
libgadu-devel                      - Development files for libgadu
libgdamm                           - C++ wrappers for libgda
libgdamm-devel                     - C++ wrappers for libgda
libgksu                            - libgksu authorization library
libgksu-devel                      - Development files for libgksu
libgksu-docs                       - libgksu referenece documents
libgpod                            - A library to access the contents of an iPod
libgpod-devel                      - Development files for libgpod
libgssglue                         - exports a gssapi interface which calls other random gssapi libraries
libgssglue-32bit                   - 32-bit shared libraries for libgssglue
libgssglue-devel                   - libgssglue development files
libgst-buzztard                    - gst-buzzard için libgst-buzztard dosyaları
libgst-buzztard-devel              - libgst-buzztard için geliştirme dosyaları
libiec61883                        - A library for capturing video (DV, MPEG2 or AMDTP) over the IEEE 1394 bus
libiec61883-devel                  - Development files for libiec61883
libieee1284                        - Library to query devices using IEEE1284
libieee1284-devel                  - Development files for libieee1284
libifp                             - A general-purpose library-driver for iRiver's iFP (flash-based) portable audio players
libifp-devel                       - Development files for libifp
libiptcdata                        - A library for manipulating the International Press Telecommunications Council (IPTC)
libiptcdata-devel                  - libiptcdata için geliştirme dosyaları
libitalc                           - Library and documentation files of iTALC
libjingle                          - Google Talk implementation of Jingle
libjingle-devel                    - Development files for libjingle
libkate                            - A text codec for embedding in Ogg
libkate-devel                      - Development files for libkate
libkate-docs                       - API documentation for libkate
liblastfm                          - A library for Last.fm integration
liblastfm-devel                    - A collection of libraries to help you integrate Last.fm services
liblastfm_fingerprint              - A collection of libraries to help you integrate Last.fm services
liblzf                             - Small data compression library
liblzf-devel                       - Development files for liblzf
libmcs                             - A modular configuration system
libmcs-devel                       - Development headers for libmcs
libmemcache                        - A library written in C for memcached
libmemcache-devel                  - Development files for libmemceche
libmnl                             - libmnl is a minimalistic user-space library for Netlink developers.
libmnl-devel                       - libmnl için geliştirme dosyaları
libmowgli                          - A development framework for C
libmowgli-devel                    - Development headers for libmowgli
libmp3splt                         - MP3 / OGG split library
libmp3splt-devel                   - Development files for libmp3splt
libmtdev                           - Multitouch Protocol Translation Library
libmtdev-devel                     - Development files of libmtdev
libmygpo-qt                        - Qt Library that wraps the gpodder.net Web API
libmygpo-qt-devel                  - Development files for libmygpo-qt
libnet                             - Low level network library
libnet-devel                       - Development files for libnet
libnetfilter-cthelper              - Library for the connection tracking helper infrastructure
libnetfilter-cthelper-devel        - libnetfilter-cthelper için geliştirme dosyaları
libnetfilter-cttimeout             - libnetfilter_cttimeout is the userspace library that provides the programming interface to the fine-grain connection tracking timeout infrastructure.
libnetfilter-cttimeout-devel       - libnetfilter-cttimeout için geliştirme dosyaları
libnetfilter_conntrack             - Connection tracking system API
libnetfilter_conntrack-devel       - Development files for libnetfilter_conntrack
libnetfilter_queue                 - Userspace API to packets that have been queued by the kernel packet filter
libnetfilter_queue-devel           - libnetfilter_queue için geliştirme dosyaları
libnice                            - GLib ICE library
libnice-devel                      - Development files for libnice
libofx                             - A library for supporting Open Financial Exchange (OFX) format
libofx-devel                       - Development files for libofx
libofx-docs                        - Documentation for libofx
libopensync-plugin-file            - File synchronization plugin for OpenSync
libopensync-plugin-gnokii          - Gnokii synchronization plugin for OpenSync
libopensync-plugin-google-calendar - Google Calendar synchronization plugin for OpenSync
libopensync-plugin-gpe             - GPE synchronization plugin for OpenSync
libopensync-plugin-ldap            - LDAP synchronization plugin for OpenSync
libopensync-plugin-palm            - Palm synchronization plugin for OpenSync
liborigin2                         - Library for reading OriginLab OPJ project files
liborigin2-devel                   - Development files for liborigin2
libp11                             - PKCS#11 library
libp11-32bit                       - 32-bit shared libraries for libp11
libp11-devel                       - Development files for libp11
libpano13                          - Library for manipulating panoramic images
libpano13-devel                    - Development files for libpano13
libplayer                          - A multimedia A/V abstraction layer library
libplayer-devel                    - Development files for libplayer
libqglviewer                       - libQGLViewer is a C++ library based on Qt that eases the creation of OpenGL 3D viewers
libqglviewer-devel                 - libQGLViewer is a C++ library based on Qt that eases the creation of OpenGL 3D viewers
libqjson                           - Qt-based library that maps JSON data to QVariant objects
libqjson-devel                     - Development files for libqjson
librpcsecgss                       - Library for RPCSECGSS support.
librpcsecgss-devel                 - librpcsecgss için geliştirme dosyaları
libshout                           - A library for communicating with and sending data to an icecast server
libshout-devel                     - Development files for libshout
libsignon-glib                     - Authorization and authentication management for glib
libsignon-glib-devel               - Development files for libsignon-glib
libsignon-glib-doc                 - Document files for libsignon-glib
libsmi                             - SMI MIB library
libsmi-devel                       - Development files for libsmi
libspectre                         - A small library for rendering Postscript documents
libspectre-32bit                   - 32-bit shared libraries for libspectre
libspectre-devel                   - Development files for libspectre
libspnav                           - Open source alternative to 3DConnextion drivers
libspnav-devel                     - Development files for libspnav
libssh                             - Full C library functions for manipulating a client-side SSH connection
libssh-devel                       - Development files for libssh
libssh-docs                        - Development documentation for libssh
libtalloc                          - Hierarchical pool based memory allocator
libtalloc-32bit                    - 32-bit shared libraries for libtalloc
libtalloc-devel                    - Development files for libtalloc
libtasn1                           - ASN.1 library used in GNUTLS
libtasn1-32bit                     - 32-bit shared libraries for libtasn1
libtasn1-devel                     - Development files for libtasn1
libtevent                          - Event system based on the talloc memory management library
libtevent-devel                    - Development files for libtevent
libtirpc                           - Transport Independent RPC library
libtirpc-32bit                     - 32-bit shared libraries for libtirpc
libtirpc-devel                     - Development files for libtirpc
libunique                          - A library for writing single instance applications
libunique-devel                    - libunique development files
libunique-docs                     - Unique reference documents
libvisio                           - A C++ library for parsing binary Microsoft Visio documents
libvisio-devel                     - A C++ library for parsing binary Microsoft Visio documents
libvisual-plugins                  - Visualization plugins for use with the libvisual framework
libvmime                           - Powerful library for MIME messages and Internet messaging services
libvmime-devel                     - Development files for libvmime
libvpx                             - WebM VP8 Codec SDK
libvpx-devel                       - libvpx header files
libzeitgeist                       - Client library for Zeitgeist
libzeitgeist-devel                 - Development files for libzeitgeist
lightmediascanner                  - Lightweight media scanner
lightmediascanner-devel            - Development files for lightmediascanner
lilycomp                           - Graphical note entry program for LilyPond
lilypond                           - GNU Music Typesetter
lirc-remotes                       - LIRC remote configuration files
lmarbles                           - Marble puzzle game
lmms                               - Linux Multimedia Studio
logrotate                          - Rotates, compresses, removes and emails system log files
loki                               - A C++ library of designs, containing flexible implementations of common design patterns and idioms
loki-devel                         - Development headers for loki
loki-docs                          - Document files for loki
loosecannon                        - 3D space adventure
loudmouth                          - Lightweight C Jabber library
loudmouth-devel                    - Development files for loudmouth
lpsolve                            - A Mixed Integer Linear Programming (MILP) solver
lpsolve-devel                      - Development files for lpsolve
lrzip                              - A (de)compressor optimised for large files
lrzip-devel                        - Development files for lrzip
lsdvd                              - Small application for listing the contents of DVDs
lshw                               - A hardware lister
lsof                               - Lists open files for running Unix processes
ltrace                             - Shows runtime library calls for dynamically linked executables
ltris                              - SDL Tetris Clone
lxc                                - Linux Resource Containers
lxc-devel                          - The linux containers development files
lxsplit                            - Hjsplit compatible file splitter/joiner
lynx                               - Lynx is the text web browser.
magicor                            - Old-school puzzle game
magicor-data                       - Magicor data files
makeself                           - A self-extracting archive generator.
mathomatic                         - Cebir programı
maxima                             - A system for the manipulation of symbolic and numerical expressions, including differentiation, integration
memonix                            - Contains brain teasers, puzzle and memory games
memonix-data                       - Data package for Memonix
memtest86                          - Memory tester
minecraft                          - A game about placing blocks
mlocate                            - A utility for finding files by name
mod_fastcgi                        - FastCGI module for Apache web server
mod_wsgi                           - An Apache module for implementing Python applications
mono-addins                        - A generic framework for creating extensible applications
mono-zeroconf                      - A cross platform Zero Configuration Networking library for Mono and .NET
mono-zeroconf-docs                 - A cross platform Zero Configuration Networking library for Mono and .NET
monodevelop                        - A free .NET development environment
monsterz                           - Bejewelled like game
mozplugger                         - A generic mozilla plug-in
mp3splt                            - A command line utility to split MP3/OGG files
mp3splt-gtk                        - Mp3splt-gtk, programı mp3 ve ogg uzantılı dosyaların belirlediğiniz alanlarını kesme ve birleştirme işlemleri sunan bir programdır.
mpck                               - Command-line MP3 checker
mpeg2vidcodec                      - MPEG Library
mpfi                               - Multiple Precision Floating-Point Interval Library
mpfi-devel                         - Development files for mpfi
mpgtx                              - MPEG audio/video/system toolbox
mrtg                               - The Multi Router Traffic Grapher
msmtp                              - A simple smtp client
msynctool                          - CLI for synchronization with OpenSync
mt-st                              - Enhanced mt command to control magnetic tape drives
multipath-tools                    - Tools to manage multipath devices using device-mapper
multitail                          - Multi-file multi-window tail
muse                               - An application for mixing, encoding, and network streaming of sound
musescore                          - Free music notation program
musicbrainz5                       - Client library to access metadata of mp3/vorbis/CD media
musicbrainz5-devel                 - Development files for musicbrainz5
myrescue                           - Myrescue: Harddisk rescue
mysql-python                       - Python bindings for MySQLdb
mythes                             - A simple thesaurus for Libreoffice
mythes-devel                       - mythes için geliştirme dosyaları
ncmpcpp                            - Ncurses based Music Player Daemon (MPD) client
ncrack                             - High-speed network authentication investigation tool
netcat                             - A tool designed to read and write data across connections using TCP/IP, OpenBSD version
netkit-ftp                         - Standard Linux FTP client
neverball                          - 3D roll-the-ball game
new_athena-fonts                   - new athena fonts
nikto                              - An Open Source (GPL) web server scanner
njam                               - Network multiplayer or singleplayer Pacman-like game
nml                                - Compiler of NML files into grf/nfo files.
nogravity-data                     - Nogravity data
notify-sharp                       - C# bindings for desktop notification
ntl                                - A Library for doing Number Theory
ntl-devel                          - Development files for ntl
ntop                               - A network traffic probe similar to the UNIX top command
ntp-client                         - NTP client
ntp-docs                           - NTP documentation
ntp-server                         - NTP server
ntrack                             - Network Connectivity Tracking library for Desktop Applications
ntrack-devel                       - Development files for ntrack library
ntrack-glib                        - Network Connectivity Tracking library for Desktop Applications
ntrack-glib-devel                  - Development files for ntrack-glib library
ntrack-gobject                     - Network Connectivity Tracking library for Desktop Applications
ntrack-gobject-devel               - Development files for ntrack-gobject library
ntrack-qt4                         - Network Connectivity Tracking library for Desktop Applications
ntrack-qt4-devel                   - Development files for ntrack-qt4 library
nut                                - Network UPS Tools
nut-devel                          - nut için geliştirme dosyaları
nx                                 - NX compression technology core libraries
ode                                - High performance library for simulating rigid body dynamics
ode-devel                          - Development files for ode
ogdi                               - Açık coğrafik veri kayıt arayüzü, GIS destek kütüphanesi
ogdi-devel                         - Development files for ogdi
ois                                - Object Oriented Input System
ois-devel                          - Development files for ois
okolaks-fonts                      - modern çizgilere sahip
okularplugin                       - Okular plugin for browsers to embed view of Okular inside browsers
openbabel                          - A chemical toolbox
openbabel-devel                    - Development files for openbabel
openconnect                        - A client for Cisco's AnyConnect VPN, which uses HTTPS and DTLS protocols
openconnect-devel                  - Development files and headers for openconnect
openjpeg                           - JPEG2000 decoding library
openjpeg-32bit                     - 32-bit shared libraries for openjpeg
openjpeg-devel                     - Development files for openjpeg
openmpi                            - A High Performance Message Passing Library
openmpi-devel                      - Development files for openmpi
opentts                            - OpenTTS speech server
opentts-devel                      - Development files and headers for OpenTTS
opera                              - Opera web browser
optipng                            - PNG Optimizer
pam_cgroups                        - PAM module for cgroups
pam_fprint                         - A simple PAM module which uses libfprint's fingerprint processing and verification functionality for authentication
pam_p11                            - PAM module for simple cryptographic token authentication
pam_skey                           - S/Key PAM module
paman                              - Management tool for PulseAudio
pan                                - A USENET newsreader for GNOME
paprefs                            - Management tool for PulseAudio
pardofont                          - Pardus like font
partimage                          - A Linux/UNIX partition imaging utility
pathological                       - Clone of the game "Logical" by Rainbow Arts
pavucontrol                        - PulseAudio Volume Control
pcb                                - Printed circuit board editor
pcf-unifont                        - GNU Unifont Glyphs
pcsx-reloaded                      - Sony Playstation emulator with good compatibility
pd                                 - Real-time patchable audio and multimedia processor
pecita-fonts                       - el yazısı
penguin-command                    - Efsanevi Missile Command oyunun GNU/Linux klonu.
pgadmin3                           - Graphical client for PostgreSQL
phpmyadmin                         - Browser based MySQL Admin Tool
pigment                            - A 3D scene graph library designed to easily create rich application user interfaces
pigment-devel                      - Development headers for pigment
pkcs11-helper                      - Library that simplifies interaction with PKCS#11 providers
pkcs11-helper-devel                - Development files for pkcs11-helper
playonlinux                        - Tool to help Linux users run Windows games on linux
plotutils                          - 2D vector graphics library
plotutils-devel                    - Development files for plotutils
pmtools                            - Collection of tools for processing ACPI tables
podofo                             - A library to work with the PDF file format
podofo-devel                       - Development files for podofo
poedit                             - A cross-platform Gettext catalogs (.po files) editor
poppler-data                       - Poppler encoding files
portmidi                           - Real-time MIDI I/O library
portmidi-devel                     - Development files for portmidi
ppracer                            - Penguin race on ice
project-starfighter                - Sidescrolling space fighter
psi                                - Fast and lightweight jabber client
psimedia                           - Psi plugin for voice/video calls
putty                              - PuTTY: A Free Telnet/SSH Client
pymol                              - PyMOL Molecular Graphics System
python-EasyGui                     - A module for GUI programming in Python
python-EasyGui-docs                - Documentation files for python-EasyGui
python-MarkupSafe                  - Implements a XML/HTML/XHTML Markup safe string for Python
python-PyX                         - Python graphics package
python-PyXML                       - Python XML module
python-PyYAML                      - The next generation YAML parser and emitter for Python
python-RuleDispatch                - Rule-based Dispatching and Generic Functions
python-SOAPpy                      - A full-featured SOAP library for Python
python-SQLObject                   - An object-relational mapper for Python programming language
python-SQLObject-docs              - python-SQLObject documentation files
python-SilverCity                  - A lexical analyser for many languages
python-Unidecode                   - US-ASCII transliterations of Unicode text
python-bsddb3                      - Python bindings for Berkeley DB
python-bsddb3-devel                - Development files for python-bsddb3
python-cx_freeze                   - Set of utilities for freezing Python scripts into executables
python-dateutil                    - dateutil datetime math and logic library for python
python-eyeD3                       - A Python module and program for processing ID3 tags
python-gammu                       - Python bindings for gammu
python-gtk                         - GTK+ bindings for Python
python-gtk-demo                    - Demo applications for python-gtk
python-gtk-devel                   - Development files for python-gtk
python-gtk-docs                    - Reference documents for python-gtk
python-libftdi                     - Python bindings for libftdi
python-libgpod                     - Python bindings for libgpod
python-libieee1284                 - Python bindings for libieee1284
python-logbook                     - A logging sytem for Python
python-logilab-astng               - Python abstract syntax tree implementation
python-logilab-common              - A bunch of modules to provide low level functionalities to Python
python-mako                        - A python templating language
python-mako-docs                   - python-mako için belgelendirme dosyaları
python-markdown                    - Python implementation of John Gruber's Markdown
python-matplotlib                  - A 2D plotting library
python-ntrack                      - Python bindings for ntrack
python-opentts                     - Python bindings for OpenTTS
python-portmidi                    - Python bindings for portmidi
python-pylint                      - Analyzes Python code looking for bugs and signs of poor quality
python-pytest                      - Testing with Python
python-pytest-doc                  - Documents and examples for py.test
python-pytest-pep8                 - pytest plugin to check source code against PEP8 requirements
python-pytextile                   - A simple text to HTML converter
python-pytz                        - World Timezone Definitions for Python
python-pyvorbis                    - Python ogg.vorbis support
python-qwt                         - Python bindings for the Qwt library
python-rapyd                       - Rapid python development with Tkinter
python-rdflib                      - RDF library for Python
python-routes                      - Routing Recognition and Generation Tools
python-routes-docs                 - python-routes için belgelendirme dosyaları
python-rpy                         - A very simple, yet robust, Python interface to the R Programming Language
python-scapy                       - Powerful interactive packet manipulation program
python-scipy                       - Scientific Tools for Python
python-simplejson                  - Simple, fast, extensible JSON encoder/decoder for Python
python-sphinx                      - Python documentation generator. It can generate HTML or Latex outputs
python-sphinx-docs                 - Documentation files for python-sphinx
python-sqlalchemy                  - SQL toolkit and Object Relational Mapper for Python
python-sqlparse                    - A non-validating SQL parser module for python
python-symboltype                  - Simple "symbol" type, useful for enumerations or sentinels
python-sympy                       - Symbolic Python library
python-tempita                     - A very small text templating language
python-tgmochikit                  - TurboGears javascript widget
python-tk_happy                    - A python module that allows a fully "wired" python Tkinter GUI application to be created in minutes
python-tornado                     - Friendfeed python web framework
python-transaction                 - Transaction management for Python
python-turbocheetah                - TurboGears plugin to support use of Cheetah templates
python-turbogears                  - TurboGears web framework
python-turbojson                   - TurboGears JSON file format support plugin
python-turbokid                    - Python template plugin that supports Kid templates
python-twitter                     - A python wrapper around the Twitter API
python-urwid                       - Console user interface library for Python
python-usb                         - Python bindings for libusb 0.x
python-v4l2capture                 - Capture video with video4linux2
python-weberror                    - Web Error handling and exception catching
python-webhelpers                  - A library of helper functions
python-webhelpers-docs             - python-webhelpers documentation files
python-webob                       - Python module that provides WSGI request and response objects
python-webpy                       - Simple and powerful web framework
python-webtest                     - Helper to test WSGI applications
python-wordaxe                     - Hyphenator for python programs
python-xattr                       - Python extension for extended file attributes
python-xcb                         - X Python binding (xpyb), based on the X C Binding (XCB) library
python-xlib                        - Xlib for Python
python-xlrd                        - Python bindings for extracting data from Microsoft Excel files
python-xlwt                        - Library to create spreadsheet files compatible with MS Excel 97/2000/XP/2003 XLS files
python-xmpppy                      - Python module for Jabber protocol
python-zodb3                       - Zope Object Database: object database and persistence
python-zodb3-devel                 - Development files for python-zodb3
python-zope-proxy                  - Generic transparent proxies for Python
python-zope-proxy-devel            - Development files for python-zope-proxy
python-zsi                         - Web service for Python
pytraffic                          - "Rush Hour" Puzzle
qbzr                               - Plugin with Qt GUI for Bazaar version control system
qcomicbook                         - An image viewer specifically designed to handle comic books
qconf                              - Autotools scripts generator for qmake-based projects
qdevelop                           - A development environment entirely dedicated to Qt4
qedje                              - A library combining the benefits of Edje and Qt
qedje-devel                        - Development files for qedje
qgit                               - A git GUI viewer built on Qt/C++
qhull                              - A library to compute convex hull geometry
qhull-devel                        - Development files for qhull
qhull-docs                         - Development documents for qhull
qimageblitz                        - An imaging library
qimageblitz-devel                  - Development files for qimageblitz
qpitch                             - Musical instrument tuner
qpopper                            - qpopper pop3 mesajlaşma protokolü için yaygın kullanılan bir sunucudur.
qstardict                          - A StarDict clone dictionary written using Qt4 libraries
qstardict-plasmoid                 - QStarDict plasmoid for KDE4
qsynth                             - fluidsynth GUI
qt-creator                         - Lightweight IDE for C++ development centering around Qt
qt-recordmydesktop                 - A graphical frontend for recordMyDesktop
qtemu                              - GUI for QEMU
qtoctave                           - Frontend for Octave
qtweetlib                          - Qt-based Twitter library
qtweetlib-devel                    - Qt-based Twitter library
qtwitter                           - Twitter client
quazip                             - A C++/Qt ZIP library
quazip-devel                       - Development files for quazip
queen                              - Adventure game Flight of the Amazon Queen
quesoglc                           - GLC renderer
quesoglc-devel                     - Development files for quesoglc
quodlibet                          - Quod Libet is a GTK+-based audio player written in Python
quota                              - System administration tools for monitoring users' disk usage
qzion                              - A canvas abstraction
qzion-devel                        - Development files for qzion
rapidminer                         - An environment for machine learning and data mining
rawtherapee                        - Free RAW converter and digital photo processing software
rdate                              - Retrieve current date and time of another machine over the web and optionally set local date and time
rfkill                             - Small tool to query rfkill devices
rpm2targz                          - RPM to .tar.gz converter
rst2pdf                            - reStructuredText to PDF converter
rtkit                              - Realtime Policy and Watchdog Daemon
sabishape                          - A simple traffic shaper based on LARTC
sablotron                          - XSL Processor
sablotron-devel                    - Development files for sablotron
sablotron-docs                     - Documentation for sablotron
sac                                - SAC is a standard interface for CSS parser
samba-swat                         - The Samba SMB server web configuration program
sane-frontends                     - Graphical frontend to SANE
sash                               - A stand-alone shell variation
schedtool                          - Scheduling policy management tool
scheherazade-fonts                 - An Arabic true type font
schroedinger                       - Dirac codec library
schroedinger-devel                 - Development files for schroedinger
scientificpython                   - A Python library for common tasks in scientific computing
scientificpython-devel             - Development headers for scientificpython
scientificpython-docs              - Documentation files for scientificpython
scribus                            - Desktop Publishing (DTP) and Layout program
scribus-devel                      - Development files for scribus
scribus-docs                       - Documentation files for scribus
sdl-gfx                            - SDL graphics drawing primitives and other support functions
sdl-gfx-32bit                      - 32-bit shared libraries for sdl-gfx
sdl-gfx-devel                      - Development files for sdl-gfx
sdl-mixer                          - SDL mixer library
sdl-mixer-32bit                    - 32-bit shared libraries for sdl-mixer
sdl-mixer-devel                    - Development files for sdl-mixer
sdl-net                            - SDL network library
sdl-net-devel                      - Development files for sdl-net
sdl-pango                          - SDL Pango library
sdl-pango-devel                    - Development files for sdl-pango
sdl-sound                          - SDL sound library
sdl-sound-devel                    - Development files for sdl-sound
sdl-ttf                            - TrueType font support for SDL
sdl-ttf-32bit                      - 32-bit shared libraries for sdl-ttf
sdl-ttf-devel                      - Development files for sdl-ttf
sdparm                             - Utility to read and write SCSI devices' parameters
secure-delete                      - Secure delete utilities
serafettin-cartoon-fonts           - The Bad Cat to Serafettin
series60-remote                    - An application that manages your mobile phone with the S60 operating system
sexy-python                        - Python bindings for libsexy
sfml                               - Simple and Fast Multimedia Library
sfml-devel                         - Development files for SFML
sfml-docs                          - Documentation files for SFML
sharutils                          - Tools to deal with shar archives
shntool                            - Wave data processor/reporter
shorten                            - Fast compressor for waveform files
signon                             - A framework for centrally storing authentication credentials
signon-devel                       - Development files for signon
signon-docs                        - Help files and API documents for signon
smartmontools                      - Programs to control and monitor storage systems using the Self-Monitoring
smbldap-tools                      - Idealx samba-ldap management tools
smc-music                          - Secret Maryo Chronicles music package
smile                              - Slideshow Maker In Linux Environement
smillaenlarger                     - a small graphical tool ( based on Qt ) to resize, especially magnify bitmaps in high quality.
smolt                              - Pisi Linux hardware profiler
smpeg                              - SDL MPEG library
smpeg-32bit                        - 32-bit shared libraries for smpeg
smpeg-devel                        - Development files for smpeg
smplayer                           - An advanced mplayer frontend
smw                                - A Super Mario multiplayer game
snack                              - The Snack Sound Toolkit
snakefood                          - Generates dependency graphs from Python code
sofia-sip                          - SIP (Sesion Initiation Protocol) Library
sofia-sip-devel                    - Development files for sofia-sip
solfege                            - A program written to help you practice ear training
sonata                             - An elegant MPD client
soundkonverter                     - SoundKonverter is a frontend to various audio converters.
soundtouch                         - Audio Processing Library
soundtouch-devel                   - Development files for soundtouch
speedcrunch                        - Fast, high precision and powerful desktop calculator
speedcrunch-docs                   - speedcrunch belgeleri
speedtouch-firmware                - ALCATEL SpeedTouch USB ADSL modem user-space driver firmware
sphinx2                            - CMU speech recognition engine
sphinx2-devel                      - Development files for sphinx2
sphinx2-docs                       - Documents for sphinx2
spice-protocol                     - Headers defining protocols for SPICE
splix                              - A set of CUPS printer drivers for SPL (Samsung Printer Language) printers
sportrop-fonts                     - Double-striped and hollow fonts
squashfs-tools                     - Userspace tools to create squashfs compressed filesystem
squirrel                           - High level imperative/OO programming language
squirrel-devel                     - Development files for squirrel
sshfs                              - A filesystem client based on the SSH FTP
stardict                           - International dictionary written for GNOME2
stardict-essential-turkish         - Stardict essential dictionaries for Turkish users
stlport                            - C++ STL Library
stlport-devel                      - Development files for stlport
strace                             - Tracks and displays system calls associated with a running process
streamripper                       - Internet radio ripper
stunnel                            - TLS/SSL - Port Wrapper.
subtitlecomposer                   - Text-based subtitles editor
subtitleripper                     - DVD subtitle to text converter
suhosin                            - Advenced Protection System for PHP
supertux                           - Side-scrolling platform game
suspend                            - A set of tools to support sleep modes
swh-plugins                        - Large collection of LADSPA audio plugins/effects
symmetrica                         - A collection of routines in C to manipulate mathematical objects
symmetrica-devel                   - Development files for symmetrica
synergy                            - A tool to share mouse, keyboard and clipboard between different computers and operating systems
syslinux                           - SysLinux, IsoLinux and PXELinux bootloader
sysstat                            - System performance tools for Linux
system-config-lvm                  - system-config-lvm is a utility for graphically configuring Logical Volumes
tachyon                            - Ray Tracing system
taglib-extras                      - Taglib extras library from Amarok team
taglib-extras-devel                - Development files for taglib-extras
taglib-sharp                       - C# implementation for TagLib
tap-plugins                        - TAP LADSPA plugins
task                               - Getting Things Done(GTD) command line utility
tclap                              - Simple templatized C++ library for parsing command line arguments.
tclap-devel                        - tclap için geliştirme dosyaları
tcltk                              - An X11 toolkit implemented with the Tcl scripting language
tcltk-devel                        - Development files for tcltk
tcsh                               - Enhanced version of the Berkeley C shell (csh)
tecnoballz                         - A brick breaker game
teeworlds                          - Online multi-player platform 2D shooter
telepathy-butterfly                - MSN connection manager for Telepathy
telepathy-gabble                   - A Jabber/XMPP connection manager for Telepathy
telepathy-idle                     - IRC connection manager for Telepathy
telepathy-logger                   - Logging utility Telepathy
telepathy-logger-devel             - Development files for telepathy-logger
telepathy-python                   - Python libraries for Telepathy
telepathy-qt                       - Qt based classes for Telepathy communication framework
telepathy-qt-devel                 - Development files for telepathy-qt
telepathy-sofiasip                 - SIP connection manager for Telepathy
telepathy-sofiasip-devel           - Development files for telepathy-sofiasip
telepathy-sunshine                 - Gadu-Gadu connection manager for telepathy
telnet-bsd                         - Telnet and telnetd
tepsonic                           - A simple, fast and lightweight Qt audio player
terminology                        - A terminal emulator for Enlightenment
terminus-font                      - Fixed point font
testdisk                           - Powerful free data recovery software
texlive-bibtexextra                - TeXLive extra BibTeX styles
texlive-fontsextra                 - TeXLive Extra fonts
texlive-formatsextra               - TeXLive Extra Formats
texlive-games                      - TeXLive Games typesettings
texlive-genericextra               - TeXLive Extra generic packages
texlive-htmlxml                    - TeXLive HTML/SGML/XML support
texlive-humanities                 - TeXLive Humanities package
texlive-langcjk                    - TeXLive Chinese, Japanese, Korean
texlive-langcyrillic               - TeXLive Cyrillic
texlive-langextra                  - TeXLive Extra Language Support,
texlive-langgreek                  - TeXLive Greek
texlive-music                      - TeXLive Music typesetting
texlive-plainextra                 - TeXLive Plain TeX
texlive-pstricks                   - TeXLive PSTricks
texlive-publishers                 - TeXLive Support for publishers and theses
texlive-science                    - TeXLive Typesetting for natural and computer sciences
texmaker                           - A free LaTeX editor
tftp                               - port of the OpenBSD TFTP server
tig                                - Git repository browser
timidity                           - Software synthesizer and MIDI converter
timidity-eawpatches                - Sound patches for Timidity (EAW)
timidity-shompatches               - Sound patches for Timidity (Shom)
tinyxml                            - A simple, small, C++ XML parser
tinyxml-devel                      - Development files for tinyxml
tmpwatch                           - Remove files based on their last access time
tn5250                             - Telnet client for the IBM AS/400
tn5250-devel                       - Development files for tn5250
togl                               - Tk OpenGL widget
togl-devel                         - Development files for togl
tolua++                            - A tool to integrate C/C++ code with Lua
tolua++-devel                      - Development files for tolua++
tomahawk                           - A meta music manager
tomahawk-devel                     - tomahawk için geliştirme dosyaları
tomatoes                           - Tomato smash game
tomatoes-data                      - Tomatoes data files
tomcat-servlet-api                 - Java Servlet API Reference Implementation
tomcat7                            - An open source servlet container developed by the Apache Software Foundation (ASF)
tor                                - an open network that helps you defend against traffic analysis
torrentinfo                        - Torrent File Viewer
torsocks                           - Use socks-friendly applications with tor
tosla                              - PC clone of traffic rush game
traceroute                         - Utility to trace the route of IP packets
trackballs-music                   - Trackballs music files
transfig                           - A set of tools for creating TeX documents with graphics
translate-toolkit                  - Helper applications for translations
translate-toolkit-docs             - Documentation files for translate-toolkit package
translator                         - Translating words in TeX
tre                                - A lightweight, robust, and efficient POSIX compliant regexp matching library
tre-devel                          - Development files for tre
tree                               - Recursive directory listing tool
turpial                            - Turpial is a mocroblogging client for social sites and networks such as Twitter and Identi.ca
tuxpaint-stamps                    - Extra stamps for Tux Paint
tv-fonts                           - TV Fonts for Xawtv
tv-viewer                          - A small application to watch and record TV
uqm-content                        - Content files for The Ur-Quan Masters
vlc-plugin                         - VLC plugin
